11 8 7 9 16 11 1 0 0 5 10 8 7 7 7 7  
10 7 9 10 7 14 0 2 0 0 11 15 11 7 14 7  
8 14 8 11 8 15 0 0 1 4 16 10 7 16 8 9  
8 11 7 11 7 16 1 5 0 2 7 14 7 8 11 7  
16 10 7 10 14 8 0 0 0 4 15 9 11 7 7 7  
7 10 7 7 7 7 5 0 5 0 11 16 10 7 8 16  
7 15 7 10 11 15 1 0 0 0 14 7 7 10 7 11  
8 11 11 7 14 7 0 4 0 6 10 11 9 7 15 7  
7 9 7 7 9 15 6 0 1 0 7 9 10 7 9 10  
7 7 7 9 16 7 1 0 2 0 15 7 8 16 7 7  
8 10 16 8 7 15 0 4 0 5 7 10 7 8 10 7  
14 9 7 7 8 14 2 0 0 4 8 14 7 7 14 7
