3 2 6 3 0 6 6 5 3 5 5 4 3 8 4 3 
0 5 0 3 0 5 3 6 2 5 8 1 7 11 10 8 
8 11 8 11 11 9 10 7 8 10 9 7 11 8 7 11 
10 11 7 10 10 7 7 10 8 7 11 11 9 7 9 7 
11 9 11 13 11 9 0 10 16 1 11 8 6 8 4 7 
6 6 4 4 3 8 7 11 10 8 11 7 8 11 11 7 
7 9 8 6 10 9 8 8 10 4 8 13 13 15 13 10 
8 14 10 15 14 16 13 14 16 14 13 15 16 13 13 13 
16 8 14 12 12 13 13 12 13 15 16 13 16 16 15 16 
15 13 16 11 11 13 13 11 13 13 16 16 12 9 14 12 
16 8 16 14 14 14 13 12 8 7 9 8 11 9 7 10 
8 7 11 11 8 11 7 10 11 7 8 7 7 9 9 8 