0 00 57 39 44 0 55 34 42 56 60 26 34 55 45 51 33 37 48 9 
49 13 13 30 60 46 50 52 46 61 48 38 38 2 48 40 39 42 36 49 
37 39 13 56 63 52 34 37 52 3 23 60 62 15 3 36 33 60 41 53 
60 39 41 57 50 51 50 47 41 40 53 58 57 42 16 49 47 62 58 57 
62 59 48 46 34 50 13 6 34 12 52 39 50 40 42 58 35 55 63 35 
45 56 52 41 52 36 9 18 7 40 52 37 49 38 35 33 47 59 37 20 
33 53 62 10 13 51 1 62 35 34 51 1 46 30 38 17 34 42 30 45 
54 58 60 56 44 63 23 53 52 59 42 43 39 57 49 41 51 63 51 62 
59 57 61 45 40 47 56 57 41 39 59 34 35 52 49 41 44 47 57 50 
39 24 63 10 41 5 43 49 62 63 58 45 49 46 44 43 63 47 57 62 
46 33 63 41 62 43 36 39 62 36 45 51 38 60 40 44 39 42 53 46 
35 35 48 50 37 56 58 33 63 53 43 37 60 38 38 50 57 37 33 43 
60 59 45 61 49 43 63 49 34 37 46 49 23 62 61 55 55 58 58 61 
54 47 42 46 55 36 52 43 54 45 39 50 36 47 42 49 33 44 58 61 
52 34 41 28 41 36 45 35 61 42 63 46 48 29 55 35 57 41 46 36 
42 62 45 52 55 53 57 58 50 46 39 56 41 44 60 46 54 38 59 56 
62 58 42 63 49 63 33 37 39 18 62 38 48 62 45 35 34 35 33 44 
36 36 45 57 61 45 54 57 33 34 38 50 59 21 41 60 24 0 61 47 
60 53 24 12 48 42 49 56 44 6 37 51 57 26 12 43 33 59 56 25 
39 53 52 62 50 54 59 51 59 45 55 38 38 62 38 62 43 48 35 53 